1,1,1,1,1,1,1
1,3,,,1,4,1
1,,,,1,,1
1,,1,1,1,5,1
1,,,,,,1
19,2,,5,,5,1
1,1,1,1,1,1,1
