11,19,11,11,11,11,11,11,11,11,11,11,11,11,11,11,11
11,5,,,,,,,,,,,,,,,11
11,1,1,1,,,,,,,,,,,,,11
11,5,,1,,,,,,,,,,,,,11
11,,,1,,,,,,,,,,,,3,11
11,,,1,,,,,1,1,1,1,1,1,1,,11
11,,,1,,,,,1,,,,,,,,11
11,,,,,,,,1,,,,,,,,11
11,2,,,,,,,1,5,,,,,,4,11
11,11,11,11,11,11,11,11,11,11,11,11,11,11,11,11,11
