11,11,11,11,11,11,11
11,3,-1,-1,1,4,11
11,-1,-1,-1,1,-1,11
11,-1,1,1,1,5,11
11,-1,-1,-1,-1,-1,11
12,2,-1,5,-1,5,11
11,11,11,11,11,11,11
