11,12,1,1,1,1,1,1,1,1,1,1,1,1,1,1,,,,,,,,,,,,,,,,
11,2,,6,,,,,1,1,1,1,1,1,1,1,,,,,,,,,,,,,,,,
1,,6,,,5,,7,1,12,,,,,,4,,,,,,,,,,,,,,,,
1,,,,16,,,,1,1,9,,,,7,1,,,,,,,,,,,,,,,,
1,7,,7,,7,,,1,1,,6,,6,10,1,,,,,,,,,,,,,,,,
1,,7,6,,,,,1,1,,,10,,,1,,,,,,,,,,,,,,,,
1,6,,,,6,,,1,1,9,6,,10,6,1,,,,,,,,,,,,,,,,
1,,,,,,,,1,1,6,9,,9,5,1,,,,,,,,,,,,,,,,
1,,12,1,12,1,12,,1,1,,9,6,,10,1,,,,,,,,,,,,,,,,
1,,7,7,,,,,1,1,9,7,10,,7,1,,,,,,,,,,,,,,,,
1,1,6,,16,7,,1,1,1,6,6,,6,10,1,,,,,,,,,,,,,,,,
1,,,7,,6,7,7,1,1,,,,,,1,,,,,,,,,,,,,,,,
1,,,,7,6,,6,,5,,,,,,1,,,,,,,,,,,,,,,,
1,,,,,7,,,,,,,,,,1,,,,,,,,,,,,,,,,
1,1,7,8,15,8,6,1,,,,,,,,1,,,,,,,,,,,,,,,,
1,1,1,1,1,1,1,1,1,1,12,11,11,11,11,1,,,,,,,,,,,,,,,,
,,,,,,,,,,,,,,,,,,,,,,,,,,,,,,,
,,,,,,,,,,,,,,,,,,,,,,,,,,,,,,,
,,,,,,,,,,,,,,,,,,,,,,,,,,,,,,,
,,,,,,,,,,,,,,,,,,,,,,,,,,,,,,,
,,,,,,,,,,,,,,,,,,,,,,,,,,,,,,,
,,,,,,,,,,,,,,,,,,,,,,,,,,,,,,,
,,,,,,,,,,,,,,,,,,,,,,,,,,,,,,,
,,,,,,,,,,,,,,,,,,,,,,,,,,,,,,,
,,,,,,,,,,,,,,,,,,,,,,,,,,,,,,,
,,,,,,,,,,,,,,,,,,,,,,,,,,,,,,,
,,,,,,,,,,,,,,,,,,,,,,,,,,,,,,,
,,,,,,,,,,,,,,,,,,,,,,,,,,,,,,,
,,,,,,,,,,,,,,,,,,,,,,,,,,,,,,,
,,,,,,,,,,,,,,,,,,,,,,,,,,,,,,,
