11,19,11,11,11,11,11,11,11,11,11,11,11,11
11,2,,,,,3,,,,,,5,11
11,1,1,,1,1,1,1,1,1,,,,11
11,,,,,,,,,,,,,11
11,,,1,,11,19,11,11,11,,1,,11
11,,,1,,11,11,11,11,11,,1,,11
11,5,,1,,,,5,,,3,1,4,11
11,11,11,11,11,11,11,11,11,11,11,11,11,11
