11,11,11,11,11,11,11,11,11,11,11,11,11,11,11,11,11
11,2,-1,-1,-1,-1,-1,-1,10,-1,-1,-1,-1,-1,-1,4,11
11,1,1,1,1,1,-1,-1,10,-1,-1,-1,-1,-1,-1,-1,11
11,-1,-1,10,10,-1,-1,-1,10,-1,-1,-1,-1,-1,-1,-1,11
11,-1,-1,10,10,-1,-1,11,11,11,-1,-1,-1,-1,-1,-1,11
11,-1,-1,1,1,1,1,11,11,11,-1,-1,-1,-1,-1,-1,11
11,-1,-1,-1,-1,-1,5,11,11,11,-1,-1,-1,-1,-1,7,11
11,-1,-1,-1,11,11,11,11,11,11,11,11,11,-1,-1,-1,11
11,-1,-1,-1,11,11,11,11,11,11,11,11,11,1,1,-1,11
11,-1,-1,-1,-1,-1,-1,11,11,11,6,-1,-1,7,1,-1,11
11,1,1,1,1,-1,-1,11,11,11,5,1,1,-1,9,-1,11
11,1,-1,3,-1,-1,-1,11,11,11,-1,1,6,6,9,-1,11
11,1,5,1,-1,-1,-1,-1,9,-1,-1,1,-1,-1,9,-1,11
11,1,-1,1,-1,-1,-1,-1,9,-1,-1,-1,-1,-1,9,-1,11
11,-1,-1,-1,-1,-1,-1,-1,9,-1,-1,1,-1,-1,9,-1,11
11,11,11,11,11,11,11,11,11,11,11,11,11,11,11,11,11
